 , , , , , , , , , , , , , ,s,s,s,s,s,s
 , , , , , , , , , , , , , ,s, , , , ,s
 , , , , , , , , , , , , , ,s, , , , ,s
 , , , , , , , , , , , , , , , , , , ,s 
 , , , , , , , , , , , , , , , , , , ,s
 , , , , , , , , , , , , , ,s, , , , ,s
 , , , , , , , , , , , , , ,s,s,s,s,s,s
 , , , , ,w,w,w,w,w,w,w,w,w,w,w,w,w,w,w
 , , , , , , , , , , , , , , , , , , , 
 , , , , , , , , , , , , , , , , , , , 
 , , , , , , , , , , , , , , , , , , , 
 , , , , , , , , , , , , , , , , , , , 
 , , , , , , , , , , , , , , , , , , , 
 , , , , , , , , , , , , , , , , , , , 
 , , , , , , , , , , , , , , , , , , , 
 
 , , , , , , , , , , , , , , , , , , , 
 , , , , , , , , , , , , , , , , , , , 
 , , , , , , , , , , , , , , , , , , , 
 , , , , , , , ,V, , , , , , , , , , , 
 , , , , , , , , , , , , , , , , , , , 
 , , , , , , , , , , , , , , , , , , , 
 , , , , , , , , , , , , , , , , , , , 
 , , , , , , , , , , , , , , , , , , , 
 , , , , , , , , , , , , , , , , , , , 
 , , , , , , , , , , , , , , , , , , , 
 , , , , , , , , , , , , , , , , , , , 
 , , , , , , , , , , , , , , , , , , , 
 , , , , , , , , , , , , , , , , , , , 
 , , , , , , , , , , , , , , , , , , , 
 , , , , , , , , , , , , , , , , , , , 
 