q,w,w,w,w,w,w,w,w,w,w,w,w,w,w,w,w,w,w,w,w,w,w,w,w,w,w,w,w,w,w,w,w,w,w,w,w,w,w,w,w,w,w,w,w,w,w,w,w,w,w,P,P,w,w,w,w,e
s, , , , , , , , , , , , , , , , , , , , , , , , , , , , , , , , , , , , , , , , , , , , , , , , , , ,p,p, , , , ,s
s, , , , , , , , , , , , , , , , , , , , , , , , , , , , , , , , , , , , , , , , , , , , , , , , , , ,p,p, , , , ,s
s, , , , , , , , , , , , , , , , , , , , , , , , , , , , , , , , , , , , , , , , , , , , , , , , , , ,p,p, , , , ,s
s, , , , , , , , , , , , , , , , , , , , , , , , , , , , , , , , , , , , , , , , , , , , , , , , , , ,p,p, , , , ,s
s, , , , ,p,p,p,p,p,p,p,p,p,p,p,p,p,p,p,p,p,p,p,p,p,p,p,p,p,p,p,p,p,p,p,p,p,p,p,p,p,p,p,p,p,p,p,p,p,p,p,p, , , , ,s
s, , , ,},p,p,p,p,p,p,p,p,p,p,p,p,p,p,p,p,p,p,p,p,p,p,p,p,p,p,p,p,p,p,p,p,p,p,p,p,p,p,p,p,p,p,p,p,p,p,p,p, , , , ,s
s, , , , ,p,p, , , , , , , , , , , , , , , , , , ,p,p, , , , , , , , , , , , , , , , , , , ,P,P, , , , , , , , , ,s
s, , , , ,p,p, , , , , , , , , , , , , , , , , , ,p,p, , , , , , , , , , , , , , , , , , , ,P,P, , , , , , , , , ,s
s, , , , ,p,p, , , , , , , , , , , , , , , , , , ,p,p, , , , , , , , , , , , , , , , , , , ,P,P, , , , , , , , , ,s
s, , , , ,p,p, , , , , , , , , , , , , , , , , , ,p,p, , , , , , , , , , , , , , , , , , , ,P,P, , , , , , , , , ,s
s, , , , ,p,p, , , , , , , , , , , , , , , , , , ,p,p, , , , , , , , , , , , , , , , , , , ,P,P, , , , , , , , , ,s
s, , , , ,p,p, , , , , , , , , , , , , , , , , , ,p,p, , , , , , , , , , , , , , , , , , , ,P,P, , , , , , , , , ,s
s, , , , ,p,p, , , , , , , , , , , , , , , , , , ,p,p, , , , , , , , , , , , , , , , , , , ,P,P, , , , , , , , , ,s
s, , , , ,p,p, , , , , , , , , , , , , , , , , , ,p,p, , , , , , , , , , , , , , , , , , , ,P,P, , , , , , , , , ,s
s, , , , ,p,p, , , , , , , , , , , , , , , , , , ,p,p, , , , , , , , , , , , , , , , , , , ,P,P, , , , , , , , , ,s
s, , , , ,p,p, , , , , , , , , , , , , , , , , , ,p,p, , , , , , , , , , , , , , , , , , , ,P,P, , , , , , , , , ,s
s, , , , ,p,p, , , , , , , , , , , , , , , , , , ,p,p, , , , , , , , , , , , , , , , , , , ,p,p, , , , , , , , , ,s
s, , , , ,p,p, , , , , , , , , , , , , , , , , , ,p,p, , , , , , , , , , , , , , , , , , , ,p,p, , , , , , , , , ,s
s, , , , ,P,P, , , , , , , , , , , , , , , , , , ,p,p, , , , , , , , , , , , , , , , , , , ,p,p, , , , , , , , , ,s
s, , , , ,P,P, , , , , , , , , , , , , , , , , , ,p,p, , , , , , , , , , , , , , , , , , , ,p,p, , , , , , , , , ,s
s, , , , ,P,P, , , , , , , , , , , , , , , , , , ,p,p, , , , , , , , , , , , , , , , , , , ,p,p, , , , , , , , , ,s
s, , , , ,P,P, , , , , , , , , , , , , , , , , , ,p,p, , , , , , , , , , , , , , , , , , , ,p,p, , , , , , , , , ,s
s, , , , ,P,P, , , , , , , , , , , , , , , , , , ,p,p, , , , , , , , , , , , , , , , , , , ,p,p, , , , , , , , , ,s
s, , , , ,P,P, , , , , , , , , , , , , , , , , , ,p,p, , , , , , , , , , , , , , , , , , , ,p,p, , , , , , , , , ,s
s, , , , ,P,P, , , , , , , , , , , , , , , , , , ,p,p, , , , , , , , , , , , , , , , , , , ,p,p, , , , , , , , , ,s
s, , , , ,P,P, , , , , , , , , , , , , , , , , , ,p,p, , , , , , , , , , , , , , , , , , , ,p,p, , , , , , , , , ,s
s, , , , ,P,P, , , , , , , , , , , , , , , , , , ,p,p, , , , , , , , , , , , , , , , , , , ,p,p, , , , , , , , , ,s
s, , , , ,P,P, , , , , , , , , , , , , , , , , , ,p,p, , , , , , , , , , , , , , , , , , , ,p,p, , , , , , , , , ,s
s, , , , ,p,p, , , , , , , , , , , , , , , , , , ,p,p, , , , , , , , , , , , , , , , , , , ,p,p, , , , , , , , , ,s
s, , , , ,p,p, , , , , , , , , , , , , , , , , , ,p,p, , , , , , , , , , , , , , , , , , , ,p,p, , , , , , , , , ,s
s, , , , ,p,p, , , , , , , , , , , , , , , , , , ,P,P, , , , , , , , , , , , , , , , , , , ,p,p, , , , , , , , , ,s
s, , , , ,p,p, , , , , , , , , , , , , , , , , , ,P,P, , , , , , , , , , , , , , , , , , , ,p,p, , , , , , , , , ,s
s, , , , ,p,p, , , , , , , , , , , , , , , , , , ,P,P, , , , , , , , , , , , , , , , , , , ,p,p, , , , , , , , , ,s
s, , , , ,p,p, , , , , , , , , , , , , , , , , , ,P,P, , , , , , , , , , , , , , , , , , , ,p,p, , , , , , , , , ,s
s, , , , ,p,p, , , , , , , , , , , , , , , , , , ,P,P, , , , , , , , , , , , , , , , , , , ,p,p, , , , , , , , , ,s
s, , , , ,p,p, , , , , , , , , , , , , , , , , , ,P,P, , , , , , , , , , , , , , , , , , , ,p,p, , , , , , , , , ,s
s, , , , ,p,p, , , , , , , , , , , , , , , , , , ,P,P, , , , , , , , , , , , , , , , , , , ,p,p, , , , , , , , , ,s
s, , , , ,p,p, , , , , , , , , , , , , , , , , , ,P,P, , , , , , , , , , , , , , , , , , , ,p,p, , , , , , , , , ,s
s, , , , ,p,p, , , , , , , , , , , , , , , , , , ,P,P, , , , , , , , , , , , , , , , , , , ,p,p, , , , , , , , , ,s
s, , , , , , , , , , , , , , , , , , , , , , , , , , , , , , , , , , , , , , , , , , , , , , , , , , , , , , , , ,s
s, , , , , , , , , , , , , , , , , , , , , , , , , , , , , , , , , , , , , , , , , , , , , , , , , , , , , , , , ,s
s, , , , , , , , , , , , , , , , , , , , , , , , , , , , , , , , , , , , , , , , , , , , , , , , , , , , , , , , ,s
s, , , , , , , , , , , , , , , , , , , , , , , , , , , , , , , , , , , , , , , , , , , , , , , , , , , , , , , , ,s
s, , , , , , , , , , , , , , , , , , , , , , , , , , , , , , , , , , , , , , , , , , , , , , , , , , , , , , , , ,s
s, , , , , , , , , , , , , , , , , , , , , , , , , , , , , , , , , , , , , , , , , , , , , , , , , , , , , , , , ,s
s, , , , , , , , , , , , , , , , , , , , , , , , , , , , , , , , , , , , , , , , , , , , , , , , , , , , , , , , ,s
a,w,w,w,w,w,w,w,w,w,w,w,w,w,w,w,w,w,w,w,w,w,w,w,w,w,w,w,w,w,w,w,w,w,w,w,w,w,w,w,w,w,w,w,w,w,w,w,w,w,w,w,w,w,w,w,w,d
 
 , , , , , , , , , , , , , , , , , , , , , , , , , , , , , , , , , , , , , , , , , , , , , , , , , , , , , , , , , 
 , , , , , , , , , , , , , , , , , , , , , , , , , , , , , , , , , , , , , , , , , , , , , , , , , ,|, , ,|, , , , 
 , , , , , , , , , , , , , , , , , , , , , , , , , , , , , , , , , , , , , , , , , , , , , , , , , ,|, , ,|, , , , 
 , , , , , , , , , , , , , , , , , , , , , , , , , , , , , , , , , , , , , , , , , , , , , , , , , ,|, , ,|, , , , 
 , , , ,|,|,|,|,|,|,|,|,|,|,|,|,|,|,|,|,|,|,|,|,|,|,|,|,|,|,|,|,|,|,|,|,|,|,|,|,|,|,|,|,|,|,|,|,|,|,|, , ,|, , , , 
 , , , ,|, , , , , , , , , , , , , , , , , , , , , , , , , , , , , , , , , , , , , , , , , , , , , , , , ,|, , , , 
 , , , ,}, , , , , , , , , , , , , , , , , , , , , , , , , , , , , , , , , , , , , , , , , , , , , , , , ,|, , , , 
 , , , ,|, , ,|,|,|,|,|,|,|,|,|,|,|,|,|,|,|,|,|,|, , ,|,|,|,|,|,|,|,|,|,|,|,|,|,|,|,|,|,|,|, , ,|,|,|,|,|,|, , , , 
 , , , ,|, , ,|, , , , , , , , , , , , , , , , ,|, , ,|, , , , , , , , , , , , , , , , , ,|, , ,|, , , , , , , , , 
 , , , ,|, , ,|, , , , , , , , , , , , , , , , ,|, , ,|, , , , , , , , , , , , , , , , , ,|, , ,|, , , , , , , , , 
 , , , ,|, , ,|, , , , , , , , , , , , , , , , ,|, , ,|, , , , , , , , , , , , , , , , , ,|, , ,|, , , , , , , , , 
 , , , ,|, , ,|, , , , , , , , , , , , , , , , ,|, , ,|, , , , , , , , , , , , , , , , , ,|, , ,|, , , , , , , , , 
 , , , ,|, , ,|, , , , , , , , , , , , , , , , ,|, , ,|, , , , , , , , , , , , , , , , , ,|, , ,|, , , , , , , , , 
 , , , ,|, , ,|, , , , , , , , , , , , , , , ,|, , , ,|, , , , , , , , , , , , , , , , , ,|, , ,|, , , , , , , , , 
 , , , ,|, , ,|, , , , , , , , , , , , , , , ,|, , , ,|, , , , , , , , , , , , , , , , , ,|, , ,|, , , , , , , , , 
 , , , ,|, , ,|, , , , , , , , , , , , , , , , ,|, , ,|, , , , , , , , , , , , , , , , , ,|, , ,|, , , , , , , , , 
 , , , ,|, , ,|, , , , , , , , , , , , , , , , ,|, , ,|, , , , , , , , , , , , , , , , , ,|, , ,|, , , , , , , , , 
 , , , ,|, , ,|, , , , , , , , , , , , , , , , ,|, , ,|, , , , , , , , , , , , , , , , , ,|, , ,|, , , , , , , , , 
 , , , ,|, , ,|, , , , , , , , , , , , , , , , ,|, , ,|, , , , , , , , , , , , , , , , , ,|, , ,|, , , , , , , , , 
 , , , ,|, , ,|, , , , , , , , , , , , , , , , ,|, , ,|, , , , , , , , , , , , , , , , , ,|, , ,|, , , , , , , , , 
 , , , ,|, , ,|, , , , , , , , , , , , , , , , ,|, , ,|, , , , , , , , , , , , , , , , , ,|, , , , , , , , , , , , 
 , , , ,|, , ,|, , , , , , , , , , , , , , , , ,|, , ,|, , , , , , , , , , , , , , , , , ,|, , , ,|, , , , , , , , 
 , , , ,|, , ,|, , , , , , , , , , , , , , , , ,|, , ,|, , , , , , , , , , , , , , , , , ,|, , , ,|, , , , , , , , 
 , , , ,|, , ,|, , , , , , , , , , , , , , , , ,|, , ,|, , , , , , , , , , , , , , , , , ,|, , , ,|, , , , , , , , 
 , , , ,|, , ,|, , , , , , , , , , , , , , , , ,|, , ,|, , , , , , , , , , , , , , , , , ,|, , ,|, , , , , , , , , 
 , ,|, , , , ,|, , , , , , , , , , , , , , , , ,|, , ,|, , , , , , , , , , , , , , , , , ,|, , ,|, , , , , , , , , 
 , , , ,|, , ,|, , , , , , , , , , , , , , , , ,|, , ,|, , , , , , , , , , , , , , , , , ,|, , ,|, , , , , , , , , 
 , , , ,|, , ,|, , , , , , , , , , , , , , , , ,|, , ,|, , , , , , , , , , , , , , , , , ,|, , ,|, , , , , , , , , 
 , , , ,|, , ,|, , , , , , , , , , , , , , , , ,|, , ,|, , , , , , , , , , , , , , , , , ,|, , ,|, , , , , , , , , 
 , , , ,|, , ,|, , , , , , , , , , , , , , , , ,|, , ,|, , , , , , , , , , , , , , , , , ,|, , ,|, , , , , , , , , 
 , , , ,|, , ,|, , , , , , , , , , , , , , , , ,|, , ,|, , , , , , , , , , , , , , , , , ,|, , ,|, , , , , , , , , 
 , , , ,|, , ,|, , , , , , , , , , , , , , , , ,|, , ,|, , , , , , , , , , , , , , , , , ,|, , ,|, , , , , , , , , 
 , , , ,|, , ,|, , , , , , , , , , , , , , , , ,|, , ,|, , , , , , , , , , , , , , , , , ,|, , ,|, , , , , , , , , 
 , , ,|,|, , ,|,|,|,|,|, , , , , , , , , ,|,|,|,|, , ,|,|,|,|,|, , , , , , , , , , , , , ,|, , ,|, , , , , , , , , 
 , , ,|, , , , , , , ,|, , , , , , , , , ,|, , , , , , , , , ,|, , , , , , , , , , , , , ,|, , ,|, , , , , , , , , 
 , , ,|, , , , , , , ,|, , , , , , , , , ,|, , , , , , , , , ,|, , , , , , , , , , , , , ,|, , ,|, , , , , , , , , 
 , , ,|, , , , , , , ,|, , , , , , , , , ,|, , , , , , , , , ,|, , , , , , , , , , , , , ,|, , ,|, , , , , , , , , 
 , , ,|, , , , , , , ,|, , , , , , , , , ,|, , , , , , , , , ,|, , , , , , , , , , , , , ,|, , ,|, , , , , , , , , 
 , , ,|, , , , , , , ,|, , , , , , , , , ,|, , , , , , , , , ,|, , , , , , , , , , , , , ,|, , ,|, , , , , , , , , 
 , , ,|, , , , , , , ,|, , , , , , , , , ,|, , , , , , , , , ,|, , , , , , , , , , , , , , , , ,|, , , , , , , , , 
 , , ,|, , , , , , , ,|, , , , , , , , , ,|, , , , , , , , , ,|, , , , , , , , , , , , , ,|,|,|,|, , , , , , , , , 
 , , ,|,|,|,|,|,|,|,|,|, , , , , , , , , ,|,|,|,|,|,|,|,|,|,|,|, , , , , , , , , , , , , , , , , , , , , , , , , , 
 , , , , , , , , , , , , , , , , , , , , , , , , , , , , , , , , , , , , , , , , , , , , , , , , , , , , , , , , , 
 , , , , , , , , , , , , , , , , , , , , , , , , , , , , , , , , , , , , , , , , , , , , , , , , , , , , , , , , , 
 , , , , , , , , , , , , , , , , , , , , , , , , , , , , , , , , , , , , , , , , , , , , , , , , , , , , , , , , , 
 , , , , , , , , , , , , , , , , , , , , , , , , , , , , , , , , , , , , , , , , , , , , , , , , , , , , , , , , , 
 , , , , , , , , , , , , , , , , , , , , , , , , , , , , , , , , , , , , , , , , , , , , , , , , , , , , , , , , , 
 , , , , , , , , , , , , , , , , , , , , , , , , , , , , , , , , , , , , , , , , , , , , , , , , , , , , , , , , , 
  
 